1,1,1,1,1,0,0,0,0,0,0,0,0,0,0,0,1,1,1,2,1,1,1,2,1,1,0,0,0,0,0,0,
1,0,0,0,1,0,0,0,0,0,0,0,0,0,0,0,1,0,-2,0,0,0,0,0,0,1,0,0,0,0,0,0,
1,0,-1,0,2,0,0,0,0,0,0,0,0,0,0,0,2,-4,0,3,0,3,0,0,0,1,1,1,2,1,1,1,
1,0,0,0,1,0,0,0,0,1,1,1,2,1,1,1,0,1,0,0,0,0,0,0,0,0,101,0,0,0,0,2,
2,1,100,1,1,0,0,0,0,1,0,0,0,0,0,1,0,1,1,1,2,1,1,1,0,0,2,0,0,0,0,1,
0,1,0,1,0,0,0,0,0,1,0,0,3,0,0,1,0,2,0,0,0,0,0,1,0,0,1,-2,0,0,0,1,
0,1,100,1,1,1,2,1,1,1,0,0,0,-3,0,2,0,1,0,0,0,0,0,1,0,1,1,2,1,100,1,1,
0,2,0,0,0,0,0,0,0,0,0,0,0,0,0,1,0,1,0,0,0,0,0,2,0,1,0,0,0,0,0,2,
0,2,0,0,0,0,0,0,0,0,0,0,3,0,0,1,0,2,0,0,3,0,0,1,1,1,0,0,0,-2,0,1,
0,1,100,1,1,1,2,1,1,1,0,0,0,0,0,1,0,1,0,0,0,0,0,0,0,0,0,0,0,0,0,1,
0,1,0,1,1,0,0,0,0,1,1,1,2,1,1,1,1,1,0,0,0,-2,0,1,1,1,0,0,0,0,0,1,
0,1,0,1,1,0,1,0,0,1,0,1,0,0,0,0,0,0,0,0,3,0,0,2,0,1,0,0,0,0,0,2,
0,2,0,2,2,0,0,0,0,0,0,101,0,0,0,-3,0,0,0,0,0,0,0,101,0,1,0,0,0,0,0,1,
0,1,0,1,1,0,1,1,0,1,2,1,1,1,1,1,2,1,0,0,0,0,0,1,0,1,1,1,2,1,1,1,
0,1,-2,1,1,0,1,1,0,0,0,0,0,0,2,0,0,1,0,0,3,0,0,1,0,-3,0,0,0,0,0,1,
0,2,0,2,2,0,2,1,2,1,2,1,1,0,1,0,0,2,0,0,0,0,0,2,0,1,1,2,1,1,0,2,
0,1,0,1,1,0,1,0,0,0,0,0,1,0,1,0,0,1,0,0,0,0,0,1,1,1,0,0,0,1,0,1,
0,1,0,1,1,0,1,0,0,0,0,0,1,0,1,0,0,1,0,0,0,0,0,1,0,0,0,-2,0,2,0,1,
0,1,100,1,1,0,1,0,0,3,0,0,2,0,2,1,1,2,1,1,2,1,0,1,0,0,0,0,0,1,0,1,
0,2,0,0,0,0,1,0,0,0,0,0,1,0,0,-2,0,0,0,0,0,0,0,0,0,0,0,0,0,1,0,2,
0,1,0,0,0,0,2,-2,0,3,0,0,1,2,1,1,1,2,1,1,0,1,1,1,2,1,1,1,2,1,100,1,
0,1,0,0,0,0,1,0,0,0,0,0,0,0,1,0,0,0,0,1,0,1,0,0,0,0,0,0,1,0,0,1,
0,1,1,100,2,1,1,0,0,3,0,0,0,0,101,0,0,0,0,1,0,1,0,0,0,0,0,0,1,0,0,1,
1,-2,0,0,0,1,0,0,0,0,0,0,0,0,1,0,-2,0,0,1,0,1,2,1,1,1,0,0,1,0,0,2,
2,0,0,0,0,1,0,0,0,0,0,0,0,0,2,0,0,0,0,1,0,101,0,0,0,1,0,0,2,0,0,1,
1,0,0,0,0,1,0,0,0,0,0,0,0,0,1,0,0,0,0,1,1,1,2,1,0,2,0,0,1,0,0,1,
1,0,0,0,0,1,1,2,1,100,1,2,1,1,1,0,0,0,0,101,0,0,0,0,0,1,0,0,1,0,0,1,
1,0,0,0,0,0,0,0,0,0,0,0,0,0,1,2,1,1,2,1,1,1,2,1,100,1,1,2,1,0,0,2,
2,0,0,-3,0,0,0,0,0,0,0,0,0,0,101,0,0,0,0,0,0,0,0,0,0,0,0,0,0,0,0,1,
1,0,0,0,0,0,0,0,0,0,0,0,1,1,1,0,0,0,0,0,0,0,0,0,0,0,0,0,-3,0,0,1,
1,0,0,0,0,0,0,0,0,0,0,0,1,0,1,-2,0,0,0,0,0,0,0,0,0,0,0,0,0,0,0,1,
1,1,1,1,2,1,1,1,2,1,1,1,0,0,0,1,2,1,1,1,2,1,1,1,2,1,1,1,2,1,1,1




El mapa debe ser de 32x32
Después de cada linea va un retorno de carro

1  	muro normal
2  	muro con luz
3  	muro con raya azul
-1 	punto inicio
-4 	punto final
-2 	alien mal hecho
-3 	demonio con pistola de la muerte 
100 	puerta horizontal
101 	puerta vertical

